1111111
0000001
1P0C0E1
1111111