111111111111111111
10000000E000000001
1000000000Z0000001
100101001C00111CC1
1000000000000000Z1
11010001100110C111
100Z00000000000001
1010C110CC10011001
10000000000Z000001
1CC100001CC0111001
10000Z000000000001
1001000110C1100111
1000000000000000Z1
1010011C0010011001
100000000000000001
100000000000000001
1000C1111111111111
1000000000000000Y1
100000000000000001
1111111111111C0001
10Y000000000000001
100000000000000001
11111110CC01111111
100000000Y00000001
110010010001001011
1000000000000Y0001
10010C111001111CC1
10000Y000000000001
101C10101C10101011
100000000000Y00001
111011100CC0110011
10000000Y000000001
1100010C0100001001
1000000000000000Y1
11101C0010C0100111
1000000000000000X1
101000100010001001
11001001CC01001001
1000000000000000Y1
100100111C01111001
1000000000000000X1
1010101C1010101011
1000000000000000W1
11101110CC00110011
1000000000000000X1
110001000100C01001
1000000000000000Y1
110C100010C0100C01
1000000000000000X1
101000100010001011
110C1001C001001001
1000000000000000X1
1001CC111001111001
1000000000000000Y1
10101010101C101011
10000000000X000001
10001110C000110011
1000000000Y0000001
11000100010C001011
1000000000000000W1
10001000100010C111
100X00000000000001
1010001000100C1011
11001001C001001001
100000000W00000001
1001C0111001111011
1000X0000000000001
10101010101C101011
1000000000000000W1
110011100000110011
1000C0000000C00001
110001000100001001
100000000000000001
1000000P00Q0000001
100000000000000001
100000000000000001
100000000000000001
100000000000000001
100000000000000001
111111111111111111