111111111
10000C1C1
1100001E1
1P0000001
111111111