1111111
100C101
1P010E1
1111111