111111111111111111
10000000E000000001
1000000000Z0000001
100101001000111001
1000000000000000Z1
110100011001100111
100Z00000000000001
101001100010011001
10000000000Z000001
100100001000111001
10000Z000000000001
100100011001100111
1000000000000000Z1
101001100010011001
100000000000000001
100000000000000001
1000C1111111111111
1000000000000000Y1
100000000000000001
1111111111111C0001
10Y000000000000001
100000000000000001
11111110CC01111111
100000000Y00000001
110010010001001011
1000000000000Y0001
100100111001111001
10000Y000000000001
101010101C10101011
100000000000Y00001
111011100000110011
10000000Y000000001
1100010C0100001001
1000000000000000Y1
11101C001000100111
1000000000000000X1
101000100010001001
110010010C01001001
1000000000000000Y1
100100111C01111001
1000000000000000X1
1010101C1010101011
1000000000000000W1
11101110CC00110011
1000000000000000X1
110001000100C01001
1000000000000000Y1
110010001000100C01
1000000000000000X1
101000100010001011
110010010001001001
1000000000000000X1
1001CC111001111001
1000000000000000Y1
10101010101C101011
10000000000X000001
100011100000110011
1000000000Y0000001
11000100010C001011
1000000000000000W1
100010001000100111
100X00000000000001
1010001000100C1011
11001001C001001001
100000000W00000001
100100111001111011
1000X0000000000001
10101010101C101011
1000000000000000W1
110011100000110011
100000000000C00001
110001000100001001
100000000000000001
1000000P0000000001
100000000000000001
100000000000000001
100000000000000001
100000000000000001
100000000000000001
111111111111111111